1111111111111
1P010000000C1
1011011110011
100001E000CC1
1111111111111
