111111111111111
1P00100000010C1
101110000001001
100010010000001
1000001C0001001
101001000101001
100000101C10001
1001C00E0001001
100010101000001
10000100C100001
111000001010111
100110010010001
110000000000101
1C01100000100C1
111111111111111
