111111111111111
1P10000001C0001
10100C010111101
101000100C00001
101001000100001
1000001C1010001
100100CE0001001
1000101C1000001
100001000100001
100000001C00001
100000010000001
111111111111111